
SO ./texture/AnyConv.com__bluestone.xpm
WE ./texture/AnyConv.com__colorstone.xpm
EA ./texture/AnyConv.com__eagle.xpm
NO ./texture/AnyConv.com__wood.xpm

C    0,157,215

F    25,51,10

1111111111111111111111111111111111111111111
100000000000000000000011111111111000000000011
1000000000000001111111111100000000000000110001
1000000000000000000000000000000000000000000111         11111111111
1000111111111110000011111111111000000111100111111       10000000001
10000000000000001111    10000000000000000111001111111    10000000001
10001111111111101       100111111111110000110001111111    111111110011
10000000000000001   1    1000000000000000011110000011111          11
10011111111111001  1111111111000000000000000000000000111
10000000100000011   1    1110000001111111111111100000111
100000001000000111111111110000000000111100000111111111
1000000000000011111111111000000000000000000011111
100000000000111111111110000000000000000011110000011111
10000000000111111111110000000000011111111111000000111
10000000000000000000000000000000000000000000000N11   
11111111111111111111111111111111111111111111111111111